222222222222222222222222222222222
200110001100000000000001100011002
200110001100000000000001100011002
200211111111111100111111111112002
200111111111111100111111111111002
200000110000000000000000011000002
200000110000000000000000011000002
200111111111114444111111111111002
200111155111444444441111551111002
200111155111114444111111551111002
200111111111114444111111111111002
200000010000000000000000010000002
200000010000000000000000010000002
200000011111115555111111110000002
200000011111115555111111110000002
200000001100000000000001100000002
200000001100000000000001100000002
200000000000000000000000000000002
200000000000000000000000000000002
222211111110004444000111111112222
200111111110001001000111111111002
200110000000011001100000000011002
200110000000011001100000000110002
200011000000011111100000001100002
200001100000000110000000011000002
200000110000000000000000110000002
200000011000000000000001100000002
211111001100000110000011001111112
200211100110000110000110011112002
200000000011009999001100000000002
200000000000009309000000000000002
200000000000009009000000000000002
222222222222222222222222222222222
