666666666666666666666666666666666
600110001100000000000001100011006
600110001100000000000001100011006
600211111111111100111111111112006
600111111111111100111111111111006
600000110000000000000000011000006
600000110000000000000000011000006
600111111111114444111111111111006
600111155111444444441111551111006
600111155111114444111111551111006
600111111111114444111111111111006
600000010000000000000000010000006
600000010000000000000000010000006
600000011111115555111111110000006
600000011111115555111111110000006
600000001100000000000001100000006
600000001100000000000001100000006
600000000000000000000000000000006
600000000000000000000000000000006
622211111110004444000111111112226
600111111110001001000111111111006
600110000000011001100000000011006
600110000000011001100000000110006
600011000000011111100000001100006
600001100000000110000000011000006
600000110000000000000000110000006
600000011000000000000001100000006
611111001100000110000011001111116
600211100110000110000110011112006
600000000011009999001100000000006
600000000000009309000000000000006
600000000000009009000000000000006
666666666666666666666666666666666
