666666666666666666666666666666666
600000000000001155500000000000006
600000000000001155500000000000006
600211111111111100111111111112006
600111111111111100111111111111006
600000000000000000000000011000006
600000000000000000000000011000006
600111111111115511111111111111006
600111122111115555111111221111006
600111122111115555111111221111006
600111111111111155111111111111006
600000010000000000000000010000006
600000010000000000000000010000006
600000011111111001111111110000006
600000011111110000111111110000006
644220022114420000244411220022446
644220022114442002444411220022446
600000000000000000000000000000006
600000000000000000000000000000006
600211111111110000111111111112006
600111111111111001111111111111006
600110000000011001100000000011006
600110000000011001100000000011006
600115522555555115555555225511006
600115555225555115555522555511006
600110000000022112200000000011006
600110000000011111100000000011006
600111111111000000001111111111006
600211111111000000001111111112006
600000000000009999000000000000006
600000000000009309000000000000006
600000000000009009000000000000006
666666666666666666666666666666666
