222222222222222222222222222222222
200000000000001155500000000000002
200000000000001155500000000000002
200211111111111100111111111112002
200111111111111100111111111111002
200000000000000000000000011000002
200000000000000000000000011000002
200111111111115511111111111111002
200111122111115555111111221111002
200111122111115555111111221111002
200111111111111155111111111111002
200000010000000000000000010000002
200000010000000000000000010000002
200000011111111001111111110000002
200000011111110000111111110000002
244220022114420000244411220022442
244220022114442002444411220022442
200000000000000000000000000000002
200000000000000000000000000000002
200211111111110000111111111112002
200111111111111001111111111111002
200110000000011001100000000011002
200110000000011001100000000011002
200115522555555115555555225511002
200115555225555115555522555511002
200110000000022112200000000011002
200110000000011111100000000011002
200111111111000000001111111111002
200211111111000000001111111112002
200000000000002112000000000000002
200000000000001301000000000000002
200000000000001001000000000000002
222222222222222222222222222222222
