666666666666666666666666666666666
600000000000000000000000000000006
600000000000000000000000000000006
600211111111111100111111111112006
600111111111111100111111111111006
600011001100000000000001100110006
600011001100000000000001100110006
600011111111112002111111111110006
600001111111111001111111111000006
600000111111110000111111110000006
600111111111000000001111111111006
600000010000000000000000010000006
655111111111000000001111111111556
600000011111115555111111110000006
600000011111115555111111110000006
600000001100000000000001100000006
600000001100000000000001100000006
644111111111000000001111111111446
600000011111115555111111110000006
600000011111115555111111110000006
600000000000000000000000000000006
600000000000000000000000000000006
611100211111111111111111112001116
611100011111111111111111110001116
600000000000000000000000000000006
600000000000000000000000000000006
600000000021111221111200000000006
600025200010000000000100002520006
600055500010000000000100005550006
600055500010009999000100005550006
600015100010009309000100001510006
600000000010009009000100000000006
666666666666666666666666666666666
