222222222222222222222222222222222
200000000000000000000000000000002
200000000000000000000000000000002
200211111111111100111111111112002
200111111111111100111111111111002
200011001100000000000001100110002
200011001100000000000001100110002
200011111111112002111111111110002
200001111111111001111111111000002
200000111111110000111111110000002
200111111111000000001111111111002
200000010000000000000000010000002
255111111111000000001111111111552
200000011111115555111111110000002
200000011111115555111111110000002
200000001100000000000001100000002
200000001100000000000001100000002
244111111111000000001111111111442
200000011111115555111111110000002
200000011111115555111111110000002
200000000000000000000000000000002
200000000000000000000000000000002
211100211111111111111111112001112
211100011111111111111111110001112
200000000000000000000000000000002
200000000000000000000000000000002
200000000021111221111200000000002
200025200010000000000100002520002
200055500010000000000100005550002
200055500010009999000100005550002
200015100010009309000100001510002
200000000010009009000100000000002
222222222222222222222222222222222
